Overview Map  (W=Warehouse  A=Agent  D=Destination)
+----------------------+
|........D..W..........|
|..........W...........|
|DW........D...........|
|......................|
|.DD...................|
|......................|
|......................|
|......................|
|......................|
|......................|
|......................|
|......................|
|......................|
|.....................A|
|......................|
|..........D..A........|
|.A.A..............A...|
|.........W............|
|...........DW.........|
|......................|
|..........D...........|
|......................|
+----------------------+

Route — Agent A1  (S=Start  W=Warehouse  D=Destination  *=path)
+----------------------+
|......................|
|......................|
|......................|
|......................|
|......................|
|......................|
|......................|
|......................|
|......................|
|......................|
|......................|
|......................|
|......................|
|......................|
|......................|
|......................|
|.S....................|
|......................|
|......................|
|......................|
|......................|
|......................|
+----------------------+

Route — Agent A2  (S=Start  W=Warehouse  D=Destination  *=path)
+----------------------+
|......................|
|......................|
|......................|
|......................|
|......................|
|......................|
|......................|
|......................|
|......................|
|......................|
|......................|
|......................|
|......................|
|.....................S|
|......................|
|......................|
|......................|
|......................|
|......................|
|......................|
|......................|
|......................|
+----------------------+

Route — Agent A3  (S=Start  W=Warehouse  D=Destination  *=path)
+----------------------+
|........D.............|
|.........*W...........|
|..........D...........|
|..........*...........|
|......................|
|..........*...........|
|......................|
|..........*...........|
|......................|
|..........*...........|
|......................|
|..........*...........|
|......................|
|..........*...........|
|......................|
|..........D..S........|
|..........*.**........|
|.........D*.*.........|
|.........*.DW.........|
|.........***..........|
|..........D*..........|
|......................|
+----------------------+

Route — Agent A4  (S=Start  W=Warehouse  D=Destination  *=path)
+----------------------+
|......................|
|......................|
|DW....................|
|**....................|
|.DD...................|
|......................|
|..*...................|
|......................|
|..*...................|
|......................|
|..*...................|
|......................|
|..*...................|
|......................|
|..*...................|
|......................|
|...S..................|
|......................|
|......................|
|......................|
|......................|
|......................|
+----------------------+

Route — Agent A5  (S=Start  W=Warehouse  D=Destination  *=path)
+----------------------+
|......................|
|......................|
|......................|
|......................|
|......................|
|......................|
|......................|
|......................|
|......................|
|......................|
|......................|
|......................|
|......................|
|......................|
|......................|
|......................|
|..................S...|
|......................|
|......................|
|......................|
|......................|
|......................|
+----------------------+

