Overview Map  (W=Warehouse  A=Agent  D=Destination)
+----------------------+
|..................A...|
|......................|
|......................|
|......................|
|......................|
|......................|
|............A.........|
|......A...............|
|......................|
|....W..........D......|
|.............D........|
|.........DAD..........|
|.............W........|
|............D.........|
|...............W......|
|......................|
|...................D.D|
|...................W..|
|..................D.D.|
|......................|
|......................|
|......................|
+----------------------+

Route — Agent A1  (S=Start  W=Warehouse  D=Destination  *=path)
+----------------------+
|......................|
|......................|
|......................|
|......................|
|......................|
|......................|
|......................|
|.....*D...............|
|....**................|
|....W.................|
|......................|
|......................|
|......................|
|......................|
|......................|
|......................|
|......................|
|......................|
|......................|
|......................|
|......................|
|......................|
+----------------------+

Route — Agent A2  (S=Start  W=Warehouse  D=Destination  *=path)
+----------------------+
|......................|
|......................|
|......................|
|......................|
|......................|
|......................|
|......................|
|......................|
|......................|
|...............D......|
|...........**D*.......|
|.........DWD**........|
|..........*.*W........|
|............D.*.......|
|.............*.*......|
|...............**.....|
|................*.*D*D|
|.................*.W*.|
|..................D*D.|
|......................|
|......................|
|......................|
+----------------------+

Route — Agent A3  (S=Start  W=Warehouse  D=Destination  *=path)
+----------------------+
|......................|
|......................|
|......................|
|......................|
|......................|
|......................|
|............S.........|
|......................|
|......................|
|......................|
|......................|
|......................|
|......................|
|......................|
|......................|
|......................|
|......................|
|......................|
|......................|
|......................|
|......................|
|......................|
+----------------------+

Route — Agent A4  (S=Start  W=Warehouse  D=Destination  *=path)
+----------------------+
|..................S...|
|......................|
|......................|
|......................|
|......................|
|......................|
|......................|
|......................|
|......................|
|......................|
|......................|
|......................|
|......................|
|......................|
|......................|
|......................|
|......................|
|......................|
|......................|
|......................|
|......................|
|......................|
+----------------------+

