Overview Map  (W=Warehouse  A=Agent  D=Destination)
+----------------------+
|..............A.......|
|......................|
|..................D...|
|...............D.D....|
|.....................A|
|................W.....|
|.....D................|
|.D....................|
|...D..................|
|...WDD................|
|...............A......|
|..W...................|
|..D...................|
|...D..................|
|......................|
|......................|
|......................|
|......................|
|......................|
|......................|
|......................|
|......................|
+----------------------+

Route — Agent A1  (S=Start  W=Warehouse  D=Destination  *=path)
+----------------------+
|......................|
|......................|
|..................D...|
|...............D*D*...|
|.................*....|
|................W.....|
|.....D........*.......|
|.D*.**......*.........|
|.**D**....*...........|
|..*WDD..*.............|
|..**..*.*.*.**.S......|
|..W**.................|
|..D*..................|
|...D..................|
|......................|
|......................|
|......................|
|......................|
|......................|
|......................|
|......................|
|......................|
+----------------------+

Route — Agent A2  (S=Start  W=Warehouse  D=Destination  *=path)
+----------------------+
|..............S.......|
|......................|
|......................|
|......................|
|......................|
|......................|
|......................|
|......................|
|......................|
|......................|
|......................|
|......................|
|......................|
|......................|
|......................|
|......................|
|......................|
|......................|
|......................|
|......................|
|......................|
|......................|
+----------------------+

Route — Agent A3  (S=Start  W=Warehouse  D=Destination  *=path)
+----------------------+
|......................|
|......................|
|......................|
|......................|
|.....................S|
|......................|
|......................|
|......................|
|......................|
|......................|
|......................|
|......................|
|......................|
|......................|
|......................|
|......................|
|......................|
|......................|
|......................|
|......................|
|......................|
|......................|
+----------------------+

