Overview Map  (W=Warehouse  A=Agent  D=Destination)
+----------------------+
|.A...A................|
|......................|
|......................|
|D..DD.................|
|..WD..................|
|.D....................|
|......................|
|...........W..........|
|......................|
|......................|
|..................D...|
|......................|
|.................DW...|
|......................|
|.....................A|
|......................|
|............A.........|
|........W.............|
|......................|
|.W........D...........|
|D..D..................|
|......................|
+----------------------+

Route — Agent A1  (S=Start  W=Warehouse  D=Destination  *=path)
+----------------------+
|.....S................|
|......................|
|......................|
|......................|
|......................|
|......................|
|......................|
|......................|
|......................|
|......................|
|......................|
|......................|
|......................|
|......................|
|......................|
|......................|
|......................|
|......................|
|......................|
|......................|
|......................|
|......................|
+----------------------+

Route — Agent A2  (S=Start  W=Warehouse  D=Destination  *=path)
+----------------------+
|......................|
|......................|
|......................|
|......................|
|......................|
|......................|
|......................|
|......................|
|......................|
|......................|
|.................*D...|
|.................*....|
|.................DW*..|
|....................*.|
|.....................S|
|......................|
|......................|
|......................|
|......................|
|......................|
|......................|
|......................|
+----------------------+

Route — Agent A3  (S=Start  W=Warehouse  D=Destination  *=path)
+----------------------+
|......................|
|......................|
|......................|
|......................|
|......................|
|......................|
|......................|
|......................|
|......................|
|......................|
|......................|
|......................|
|......................|
|......................|
|......................|
|......................|
|..........*.S.........|
|.......*W*............|
|....*.**.**...........|
|.W.***....D...........|
|D**D..................|
|......................|
+----------------------+

Route — Agent A4  (S=Start  W=Warehouse  D=Destination  *=path)
+----------------------+
|.S....................|
|..*...................|
|..*...................|
|D**DD.................|
|.*DD..................|
|.D*...................|
|......................|
|......................|
|......................|
|......................|
|......................|
|......................|
|......................|
|......................|
|......................|
|......................|
|......................|
|......................|
|......................|
|......................|
|......................|
|......................|
+----------------------+

