Overview Map  (W=Warehouse  A=Agent  D=Destination)
+----------------------+
|................D.W...|
|......................|
|.................D....|
|.................D....|
|.....................A|
|...........A..W.......|
|......A...............|
|......................|
|........W.....A.......|
|..........D...........|
|......................|
|......................|
|......................|
|......................|
|......................|
|.......D..............|
|.........D............|
|........W.............|
|........D.............|
|........D.............|
|......................|
|......................|
+----------------------+

Route — Agent A1  (S=Start  W=Warehouse  D=Destination  *=path)
+----------------------+
|......................|
|......................|
|......................|
|......................|
|......................|
|......................|
|......S*..............|
|.......**.............|
|........W*............|
|.........*D...........|
|......................|
|......................|
|......................|
|......................|
|......................|
|......................|
|......................|
|......................|
|......................|
|......................|
|......................|
|......................|
+----------------------+

Route — Agent A2  (S=Start  W=Warehouse  D=Destination  *=path)
+----------------------+
|......................|
|......................|
|......................|
|......................|
|......................|
|...........S..........|
|......................|
|......................|
|......................|
|......................|
|......................|
|......................|
|......................|
|......................|
|......................|
|......................|
|......................|
|......................|
|......................|
|......................|
|......................|
|......................|
+----------------------+

Route — Agent A3  (S=Start  W=Warehouse  D=Destination  *=path)
+----------------------+
|................D*W...|
|................*.**..|
|.................D.**.|
|.................D..**|
|.....................S|
|......................|
|......................|
|......................|
|......................|
|......................|
|......................|
|......................|
|......................|
|......................|
|......................|
|......................|
|......................|
|......................|
|......................|
|......................|
|......................|
|......................|
+----------------------+

Route — Agent A4  (S=Start  W=Warehouse  D=Destination  *=path)
+----------------------+
|......................|
|......................|
|......................|
|......................|
|......................|
|......................|
|......................|
|......................|
|..............S.......|
|.............*........|
|............*.........|
|......................|
|...........*..........|
|...........*..........|
|..........*...........|
|.......D*.............|
|........*D............|
|........W*............|
|........D*............|
|........D.............|
|......................|
|......................|
+----------------------+

