Overview Map  (W=Warehouse  A=Agent  D=Destination)
+----------------------+
|..................D..D|
|.........A.......A.A..|
|.....................W|
|...................D..|
|........D.W...........|
|......................|
|......................|
|......................|
|......................|
|......................|
|......................|
|......................|
|......................|
|...................W..|
|......................|
|......................|
|......................|
|......................|
|......................|
|......................|
|....A.................|
|................DW....|
+----------------------+

Route — Agent A1  (S=Start  W=Warehouse  D=Destination  *=path)
+----------------------+
|......................|
|.................S....|
|......................|
|......................|
|......................|
|......................|
|......................|
|......................|
|......................|
|......................|
|......................|
|......................|
|......................|
|......................|
|......................|
|......................|
|......................|
|......................|
|......................|
|......................|
|......................|
|......................|
+----------------------+

Route — Agent A2  (S=Start  W=Warehouse  D=Destination  *=path)
+----------------------+
|......................|
|......................|
|......................|
|......................|
|......................|
|......................|
|......................|
|......................|
|......................|
|......................|
|......................|
|......................|
|......................|
|......................|
|......................|
|......................|
|......................|
|......................|
|......................|
|......................|
|....S.*.*.*...........|
|...........*.*.*DW....|
+----------------------+

Route — Agent A3  (S=Start  W=Warehouse  D=Destination  *=path)
+----------------------+
|..................D**D|
|...................S**|
|...................**W|
|...................D..|
|......................|
|......................|
|......................|
|......................|
|......................|
|......................|
|......................|
|......................|
|......................|
|......................|
|......................|
|......................|
|......................|
|......................|
|......................|
|......................|
|......................|
|......................|
+----------------------+

Route — Agent A4  (S=Start  W=Warehouse  D=Destination  *=path)
+----------------------+
|......................|
|.........S............|
|.........*............|
|.........**...........|
|........D*W...........|
|......................|
|......................|
|......................|
|......................|
|......................|
|......................|
|......................|
|......................|
|......................|
|......................|
|......................|
|......................|
|......................|
|......................|
|......................|
|......................|
|......................|
+----------------------+

