Overview Map  (W=Warehouse  A=Agent  D=Destination)
+----------------------+
|.....D................|
|......................|
|......W.D.............|
|......................|
|......D...............|
|......A...............|
|......................|
|......................|
|...................A..|
|....................A.|
|......................|
|......................|
|W.D...................|
|D....DD...............|
|......W...............|
|.....................W|
|....................D.|
|......................|
|......................|
|..A...................|
|......................|
|......................|
+----------------------+

Route — Agent A1  (S=Start  W=Warehouse  D=Destination  *=path)
+----------------------+
|......................|
|......................|
|......................|
|......................|
|......................|
|......................|
|......................|
|......................|
|...................S..|
|......................|
|......................|
|......................|
|......................|
|......................|
|......................|
|......................|
|......................|
|......................|
|......................|
|......................|
|......................|
|......................|
+----------------------+

Route — Agent A2  (S=Start  W=Warehouse  D=Destination  *=path)
+----------------------+
|......................|
|......................|
|......................|
|......................|
|......................|
|......................|
|......................|
|......................|
|......................|
|....................S.|
|....................*.|
|....................*.|
|....................**|
|.....................*|
|.....................*|
|.....................W|
|....................D*|
|......................|
|......................|
|......................|
|......................|
|......................|
+----------------------+

Route — Agent A3  (S=Start  W=Warehouse  D=Destination  *=path)
+----------------------+
|......................|
|......................|
|......................|
|......................|
|......................|
|......................|
|......................|
|......................|
|......................|
|......................|
|......................|
|......................|
|W*D*..................|
|D**.*DD...............|
|.....*D...............|
|.....*................|
|....*.................|
|....*.................|
|..**..................|
|..S...................|
|......................|
|......................|
+----------------------+

Route — Agent A4  (S=Start  W=Warehouse  D=Destination  *=path)
+----------------------+
|.....D................|
|.....*................|
|.....*W*D.............|
|.....***..............|
|......D...............|
|......S...............|
|......................|
|......................|
|......................|
|......................|
|......................|
|......................|
|......................|
|......................|
|......................|
|......................|
|......................|
|......................|
|......................|
|......................|
|......................|
|......................|
+----------------------+

