Overview Map  (W=Warehouse  A=Agent  D=Destination)
+----------------------+
|..............D.......|
|...........A..........|
|................W.....|
|........D........D....|
|......................|
|.........W............|
|...........A..........|
|......................|
|......................|
|.....................D|
|.....D.............WD.|
|.....A...D.........D..|
|.A...D.W..............|
|......................|
|........D.............|
|......................|
|......................|
|......................|
|......................|
|......................|
|..............A.......|
|....W.................|
+----------------------+

Route — Agent A1  (S=Start  W=Warehouse  D=Destination  *=path)
+----------------------+
|..............D*......|
|...........S*..*......|
|.............***W.....|
|.................D....|
|......................|
|......................|
|......................|
|......................|
|......................|
|......................|
|......................|
|......................|
|......................|
|......................|
|......................|
|......................|
|......................|
|......................|
|......................|
|......................|
|......................|
|......................|
+----------------------+

Route — Agent A2  (S=Start  W=Warehouse  D=Destination  *=path)
+----------------------+
|......................|
|......................|
|......................|
|........D.............|
|........**............|
|.........W............|
|...........S**........|
|.............***......|
|...............**.....|
|................***..D|
|..................*WD*|
|...................D..|
|......................|
|......................|
|......................|
|......................|
|......................|
|......................|
|......................|
|......................|
|......................|
|......................|
+----------------------+

Route — Agent A3  (S=Start  W=Warehouse  D=Destination  *=path)
+----------------------+
|......................|
|......................|
|......................|
|......................|
|......................|
|......................|
|......................|
|......................|
|......................|
|......................|
|.....D................|
|.....D***D............|
|.....D*W..............|
|.......**.............|
|........D.............|
|......................|
|......................|
|......................|
|......................|
|......................|
|......................|
|......................|
+----------------------+

Route — Agent A4  (S=Start  W=Warehouse  D=Destination  *=path)
+----------------------+
|......................|
|......................|
|......................|
|......................|
|......................|
|......................|
|......................|
|......................|
|......................|
|......................|
|......................|
|......................|
|......................|
|......................|
|......................|
|......................|
|......................|
|......................|
|......................|
|......................|
|..............S.......|
|......................|
+----------------------+

Route — Agent A5  (S=Start  W=Warehouse  D=Destination  *=path)
+----------------------+
|......................|
|......................|
|......................|
|......................|
|......................|
|......................|
|......................|
|......................|
|......................|
|......................|
|......................|
|......................|
|.S....................|
|......................|
|......................|
|......................|
|......................|
|......................|
|......................|
|......................|
|......................|
|......................|
+----------------------+

