Overview Map  (W=Warehouse  A=Agent  D=Destination)
+----------------------+
|.................D....|
|...............DW.....|
|......................|
|.............D........|
|......................|
|....................A.|
|......................|
|.......D..............|
|.....D.W..............|
|...............D......|
|......A.........D....D|
|.A................W...|
|......................|
|......................|
|......................|
|......................|
|......................|
|......................|
|..........A...........|
|......................|
|......................|
|......................|
+----------------------+

Route — Agent A1  (S=Start  W=Warehouse  D=Destination  *=path)
+----------------------+
|................*D....|
|...............DW.....|
|..............****....|
|.............D*..**...|
|...................*..|
|.................*..S.|
|.................*....|
|......................|
|..................*...|
|...............D***...|
|................D****D|
|..................W...|
|......................|
|......................|
|......................|
|......................|
|......................|
|......................|
|......................|
|......................|
|......................|
|......................|
+----------------------+

Route — Agent A2  (S=Start  W=Warehouse  D=Destination  *=path)
+----------------------+
|......................|
|......................|
|......................|
|......................|
|......................|
|......................|
|......................|
|......................|
|......................|
|......................|
|......................|
|.S....................|
|......................|
|......................|
|......................|
|......................|
|......................|
|......................|
|......................|
|......................|
|......................|
|......................|
+----------------------+

Route — Agent A3  (S=Start  W=Warehouse  D=Destination  *=path)
+----------------------+
|......................|
|......................|
|......................|
|......................|
|......................|
|......................|
|......................|
|......*D..............|
|.....D*W..............|
|......**..............|
|......S...............|
|......................|
|......................|
|......................|
|......................|
|......................|
|......................|
|......................|
|......................|
|......................|
|......................|
|......................|
+----------------------+

Route — Agent A4  (S=Start  W=Warehouse  D=Destination  *=path)
+----------------------+
|......................|
|......................|
|......................|
|......................|
|......................|
|......................|
|......................|
|......................|
|......................|
|......................|
|......................|
|......................|
|......................|
|......................|
|......................|
|......................|
|......................|
|......................|
|..........S...........|
|......................|
|......................|
|......................|
+----------------------+

