Overview Map  (W=Warehouse  A=Agent  D=Destination)
+----------------------+
|....................A.|
|......................|
|......................|
|......................|
|......................|
|......................|
|......................|
|......................|
|......................|
|......................|
|......................|
|......................|
|.........D............|
|......................|
|.......W..............|
|.D....................|
|...........A.....DW...|
|....AD............A...|
|...W....D.............|
|..D.....D.............|
|.DD....W............W.|
|.....................D|
+----------------------+

Route — Agent A1  (S=Start  W=Warehouse  D=Destination  *=path)
+----------------------+
|......................|
|......................|
|......................|
|......................|
|......................|
|......................|
|......................|
|......................|
|......................|
|......................|
|......................|
|......................|
|......................|
|......................|
|......................|
|......................|
|.................DW...|
|..................D*..|
|..................**..|
|...................**.|
|...................*W*|
|....................*D|
+----------------------+

Route — Agent A2  (S=Start  W=Warehouse  D=Destination  *=path)
+----------------------+
|......................|
|......................|
|......................|
|......................|
|......................|
|......................|
|......................|
|......................|
|......................|
|......................|
|......................|
|......................|
|.........D............|
|.......**.............|
|.......W*.............|
|.........**...........|
|...........S..........|
|......................|
|......................|
|......................|
|......................|
|......................|
+----------------------+

Route — Agent A3  (S=Start  W=Warehouse  D=Destination  *=path)
+----------------------+
|......................|
|......................|
|......................|
|......................|
|......................|
|......................|
|......................|
|......................|
|......................|
|......................|
|......................|
|......................|
|......................|
|......................|
|......................|
|.D....................|
|..*...................|
|..**SD................|
|..*W*..*D.............|
|..D*.***D.............|
|.DD....W..............|
|......................|
+----------------------+

Route — Agent A4  (S=Start  W=Warehouse  D=Destination  *=path)
+----------------------+
|....................S.|
|......................|
|......................|
|......................|
|......................|
|......................|
|......................|
|......................|
|......................|
|......................|
|......................|
|......................|
|......................|
|......................|
|......................|
|......................|
|......................|
|......................|
|......................|
|......................|
|......................|
|......................|
+----------------------+

